  R    1500  1000
SO        images/grey_stone.xpm
WE        images/img1.xpm
           EA        images/redbrick.xpm
            NO       images/eagle.xpm

    S         images/barrel.xpm
     F    50,255,255
   C 120,130,120

1111111111111111111
10000000000011001111
11110001100110011111
11110000000001100011
1000001100110011111
10000W0010100000100111
1110000000000011000001
111111111111111111111
