  R    100  100
SO        images/grey_stone.xpm
WE        images/img1.xpm
           EA        images/redbrick.xpm
            NO       images/eagle.xpm

    S         images/barrel.xpm
     F    50,255,255
   C 120,130,120

11111111111111111111 1111
100000001010101011111101
100N000000000000000000111
100000000000001000011111
111100011001100111111111
111100000000011000111111
100000110011001111111111
100000010100000100111111
11111110011111111111111
111110001111100011100111
100000000010000000000011
100000000100011111100011
111000000000001100000111
111111111111111111111111
