    R    1000   1000

  NO       images/eagle.xpm
SO        images/grey_stone.xpm
WE        images/img1.xpm
           EA        images/redbrick.xpm

   S         images/barrel.xpm

     F    255,0,255
   C          255,200,10

1111
10N1
1111
