R    2000  1500
     SO        images/grey_stone.xpm
WE        images/img1.xpm
           EA        images/redbrick.xpm
            NO       images/eagle.xpm

    S         images/barrel.xpm
     F    50,255,255
   C 120,130,120


     1111111111111111111111111
     1000000000110000000000001
     1011000001110000002000001
     100100000W000000000000000111
111111111011000001110000000000001
1100000000011000001110111111111111
11110111111111011100000010001
11110111111111011101010010001
11000000110101011100000010001
10002000000000001100000010001
10000000000000001101010010001
110000011101010111110111100111
11110111 1110101 101111010001
11111111 1111111 111111111111
