R    1000  1000
     SO        images/grey_stone.xpm
WE        images/img1.xpm
           EA        images/redbrick.xpm
            NO       images/eagle.xpm

    S         images/barrel.xpm
     F    50,255,255
   C 120,130,120

111111111111111111111111111111
1000000000110000000000001111111
101100000111000S0000000011111111
10010000000000000000000011111111
111111111011000001110000000000001
100000000011000001110111111111111
11110111111111011100000010001
11110111111111011101010010001
11000000110101011100000010001
10001000000000001100000010001
10000000000000001101010010001
110000011101010111110111100111
111101111110101101111010001111
11111111111111111111111111111
