R     1000 10

NO        images/eagle.xpm
SO        images/grey_stone.xpm
WE        images/img1.xpm
EA        images/redbrick.xpm

S         images/barrel.xpm

F    250,100,255
C          255,200,10



1111111111      1111
100201001111111111111
1000110011
11000N11001
100001101111111111                        1
1111111111111
