    R    1000   1000

  NO       images/eagle.xpm
SO        images/grey_stone.xpm
WE        images/img1.xpm
           EA        images/redbrick.xpm

   S         images/barrel.xpm

     F    255,0,255
   C          255,200,10

11111111111111111111
10000000000011001111
11110001100110011111
11110000000001100011
100000110N0110011111
101010101010010001111
11111111111111111111
