R   1000     600

NO images/eagle.xpm
SO images/grey_stone.xpm
WE images/img1.xpm
EA images/redbrick.xpm

S images/barrel.xpm

F 220,100,0
C 225,30,0



11111111110
100201001
1000110011
11000N11001
10000110111111
1111111111111
