    R    1000   1000

  NO       images/eagle.xpm
SO        images/grey_stone.xpm
WE        images/img1.xpm
           EA        images/redbrick.xpm

   S         images/barrel.xpm

     F    250,0,255
   C          255,200,10




    1
  1
111111111
1000N0001
111111111
11111111
10000001
1111111
