    R    1000  1500

  NO       images/eagle.xpm
SO        images/grey_stone.xpm
WE        images/img1.xpm
           EA        images/redbrick.xpm

   S         images/barrel.xpm

     F    255,0,255
   C          255,200,10
 C          255,200,10


11111111111111111111
10000000000011001111
11110001100110011111
11110000000001100011
1N000001100110011111
11111111111111111111
