R 1000 600

NO images/eagle.xpm
SO images/grey_stone.xpm
WE images/img1.xpm
EA images/redbrick.xpm

S images/barrel.xpm

F 220,100,0
C 225,30,0

1111111111
111111111
10020110011111111111
1000110011
11000011001
10000110111111
111111111111
